NO src/texture/night.xpm
SO src/texture/night.xpm
WE src/texture/night.xpm
EA src/texture/night.xpm
F 0,0,0
C 7,29,57

11111111
11111111 
10000001
10000001
10000001
100E0001
10000001
10000001   
10000001
11111111