NO src/texture/pastel.xpm
SO src/texture/pastel.xpm
WE src/texture/pastel.xpm
EA src/texture/pastel.xpm
F 247,211,210
C 232,185,189

11111111
11111111 
10000001
10001001
10000001
100E0001
10000101
10100001   
10000001
11111111