NO                        src/maps/valid_map.cub    
F      0    ,    25,       120

EA    src/maps/valid_map.cub

C                255      , 5,255

WE               src/maps/valid_map.cub      

SO       src/maps/valid_map.cub   


11111111111111111111111111111111111111111111
10000000000000011111111111111111111111111111
1000000000000000000000000000000000101010111111100
11111111111111111111111101111111111111101111000000001110
100000000000000000000000000000000010101011111
10000000000000E00000000000000000001010101111
10000000000000000000000000000000001010101111
10000000000000000000000000000000001010101111
100000000000000000000000000000000010101011
11111111111111111111111111111111111111111111
